You can barely hear yourself think. You were hoping the storm would let up, but it's only getting stronger. You feel your heart racing. If this keeps up, you could very well die. Suddenly, to your right, you see a small house, with a "For Sale" sign on the front lawn.  It will have to do. You move up the walkway, and step onto the front porch, knowing that this is your only hope for refuge.

Refuge
An Interactive Fiction by Dan Malear and Edward Ramirez
Release 1 / Serial number 130314 / Inform 7 build 6G60 (I6/v6.32 lib 6/12N) SD

Current table:
Name: refrigerator, Used: true, Used by: refrigerator
Name: oven, Used: false, Used by: Nothing
Name: microwave, Used: false, Used by: Nothing
Name: stove, Used: false, Used by: Nothing

Front Porch
The front porch is hardly a respite; there is no cover from the storm whatsoever. Other than the light, wooden railing surrounding it, the porch has nothing but the dry, wooden floor.

>ffjh j
That's not a verb I recognize.

>yes!
That's not a verb I recognize.

>l
Kitchen
The kitchen is dirty as hell.

You can see a refrigerator here.

>l
Kitchen
The kitchen is dirty as hell.

You can see a refrigerator here.

>fff
That's not a verb I recognize.

>l
Kitchen
The kitchen is dirty as hell.

You can see a refrigerator here.

* * *

>x kitchen
You can't see any such thing.

>l
Kitchen
The kitchen is dirty as hell.

You can see a refrigerator here.

* * *

>x kitchen
You can't see any such thing.

>n
(first opening the front door)

Kitchen
The kitchen is silent and untouched.

There is a refrigerator in the corner.

>x kitchen
Kitchen
The kitchen is silent and untouched.

There is a refrigerator in the corner.

* * *

>x kitchn
You can't see any such thing.

>x kitchen
You can't see any such thing.

* * *

>x refrigerator
You see nothing special about the refrigerator.

>l
Kitchen
The kitchen is silent and untouched.

There is a pristine white refrigerator in the corner.

* * *

>x floor
The rain has soaked thoroughly into the wood. It will certainly be ruined when the storm passes.

>l
Front Porch
The front porch is hardly a respite; there is no cover from the storm whatsoever. Other than the light, wooden railing surrounding it, the porch holds nothing but the sopping wooden floor.

>n
(first opening the front door)

Kitchen
The kitchen is silent and untouched.

There is a grungy, red refrigerator in the corner.

>x refrigerator
The refrigerator looks like it was made recently, with a polished white surface, and an ice/water dispenser

>l
Kitchen
The kitchen is silent and untouched.

There is a pristine, white refrigerator in the corner.

* * *

>n
(first opening the front door)

Current table:
Name: refrigerator, Used: true, Used by: refrigerator
Name: oven, Used: false, Used by: Nothing
Name: microwave, Used: false, Used by: Nothing
Name: stove, Used: false, Used by: Nothing
0 + 1 < 2(Also resetting)(reset called)(clear called)
Kitchen
The kitchen is silent and untouched.

There is a refrigerator in the corner.

>actions
Actions listing on.

>n
[going north]
You can't go that way.
[going north - failed the can't go through undescribed doors rule]

* * *

>n
(first opening the front door)

Current table:
Name: refrigerator, Used: true, Used by: refrigerator
Name: oven, Used: false, Used by: Nothing
Name: microwave, Used: false, Used by: Nothing
Name: stove, Used: false, Used by: Nothing
0 + 1 < 2(Also resetting)(reset called)(clear called)
Kitchen
The kitchen is silent and untouched.

There is a refrigerator in the corner.

>x fridge
The refrigerator looks like it was made recently, with a polished white surface, and an ice/water dispenser

>l
Kitchen
The kitchen is silent and untouched.

There is a pristine, white refrigerator in the corner.

>x grungy red fridge
The refrigerator looks like it was made recently, with a polished white surface, and an ice/water dispenser

>l
Kitchen
The kitchen is silent and untouched.

There is a pristine, white refrigerator in the corner.

>x poop fridge
You can't see any such thing.

>l
Kitchen
The kitchen is silent and untouched.

There is a pristine, white refrigerator in the corner.

>x red fridge
The refrigerator looks like it was made recently, with a polished white surface, and an ice/water dispenser

>l
Kitchen
The kitchen is silent and untouched.

There is a pristine, white refrigerator in the corner.

>x fridge
The refrigerator looks like it was made recently, with a polished white surface, and an ice/water dispenser

* * *

>l
Kitchen
The kitchen is silent and untouched.

There is a pristine, white refrigerator in the corner.

>exit
But you aren't in anything at the moment.

>quit
Are you sure you want to quit?

* * *

>n
(first opening the front door)

Current table:
Name: refrigerator, Used: true, Used by: refrigerator
Name: oven, Used: false, Used by: Nothing
Name: microwave, Used: false, Used by: Nothing
Name: stove, Used: false, Used by: Nothing
0 + 1 < 2(Also resetting)(reset called)(clear called)
Kitchen
The kitchen is silent and untouched.

There is a refrigerator in the corner.

>x kitchen
You can't see any such thing.

>x
(the refrigerator)
The refrigerator looks like it was made recently, with a polished white surface, and an ice/water dispenser

>l
Kitchen
The kitchen is silent and untouched.

There is a refrigerator in the corner.

* * *

>n
(first opening the front door)

Current table:
Name: refrigerator, Used: true, Used by: refrigerator
Name: oven, Used: false, Used by: Nothing
Name: microwave, Used: false, Used by: Nothing
Name: stove, Used: false, Used by: Nothing
0 + 1 < 2(Also resetting)(reset called)(clear called)
Kitchen
The kitchen is silent and untouched.

There is a refrigerator in the corner.

>l
Current table:
Name: refrigerator, Used: true, Used by: refrigerator
Name: oven, Used: false, Used by: Nothing
Name: microwave, Used: false, Used by: Nothing
Name: stove, Used: false, Used by: Nothing
0 + 0 < 2
Kitchen
The kitchen is silent and untouched.

There is a refrigerator in the corner.

>l
Current table:
Name: refrigerator, Used: true, Used by: refrigerator
Name: oven, Used: false, Used by: Nothing
Name: microwave, Used: false, Used by: Nothing
Name: stove, Used: false, Used by: Nothing
0 + 0 < 2
Kitchen
The kitchen is silent and untouched.

There is a refrigerator in the corner.

>l
Current table:
Name: refrigerator, Used: true, Used by: refrigerator
Name: oven, Used: false, Used by: Nothing
Name: microwave, Used: false, Used by: Nothing
Name: stove, Used: false, Used by: Nothing
0 + 1 < 2
Kitchen
The kitchen is silent and untouched.

There is a refrigerator in the corner.

>l
Current table:
Name: refrigerator, Used: true, Used by: refrigerator
Name: oven, Used: false, Used by: Nothing
Name: microwave, Used: false, Used by: Nothing
Name: stove, Used: false, Used by: Nothing
0 + 0 < 2
Kitchen
The kitchen is silent and untouched.

There is a refrigerator in the corner.

* * *

>l
Current table:
Name: refrigerator, Used: true, Used by: refrigerator
Name: oven, Used: false, Used by: Nothing
Name: microwave, Used: false, Used by: Nothing
Name: stove, Used: false, Used by: Nothing
0 + 1 < 2
Kitchen
The kitchen is silent and untouched.

There is a refrigerator in the corner.

>l
Current table:
Name: refrigerator, Used: true, Used by: refrigerator
Name: oven, Used: false, Used by: Nothing
Name: microwave, Used: false, Used by: Nothing
Name: stove, Used: false, Used by: Nothing
0 + 2 >= 2(random name called)(clear called)
Kitchen
The kitchen is silent and untouched.

There is a stove in the corner.

>l
0 + 1 < 2
Current table:
Name: refrigerator, Used: true, Used by: refrigerator
Name: oven, Used: false, Used by: Nothing
Name: microwave, Used: false, Used by: Nothing
Name: stove, Used: false, Used by: Nothing

Kitchen
The kitchen is silent and untouched.

There is a refrigerator in the corner.

>l
0 + 0 < 2
Current table:
Name: refrigerator, Used: true, Used by: refrigerator
Name: oven, Used: false, Used by: Nothing
Name: microwave, Used: false, Used by: Nothing
Name: stove, Used: false, Used by: Nothing

Kitchen
The kitchen is silent and untouched.

There is a refrigerator in the corner.

>l
0 + 2 >= 2(random name called)(clear called)
Current table:
Name: stove, Used: true, Used by: refrigerator
Name: microwave, Used: false, Used by: Nothing
Name: refrigerator, Used: false, Used by: Nothing
Name: oven, Used: false, Used by: Nothing

Kitchen
The kitchen is silent and untouched.

There is a stove in the corner.

>l
0 + 2 >= 2
Kitchen
The kitchen is silent and untouched.

There is an oven in the corner.

>l
0 + 1 < 2
Kitchen
The kitchen is silent and untouched.

There is a refrigerator in the corner.

>l
0 + 2 >= 2
Kitchen
The kitchen is silent and untouched.

There is a refrigerator in the corner.

>l
0 + 2 >= 2
Kitchen
The kitchen is silent and untouched.

There is an oven in the corner.

I beg your pardon?

I beg your pardon?

>l
Kitchen
The kitchen is silent and untouched.

There is a refrigerator in the corner.

>l
Kitchen
The kitchen is silent and untouched.

There is a refrigerator in the corner.

I beg your pardon?

* * *

>l
0 + 2 >= 2
Kitchen
The kitchen is silent and untouched.

There is an oven in the corner.

>l
0 + 0 < 2
Kitchen
The kitchen is silent and untouched.

There is a refrigerator in the corner.

>l
0 + 1 < 2
Kitchen
The kitchen is silent and untouched.

There is a refrigerator in the corner.

>l
0 + 2 >= 2
Kitchen
The kitchen is silent and untouched.

There is a microwave in the corner.

>l
0 + 1 < 2
Kitchen
The kitchen is silent and untouched.

There is a refrigerator in the corner.

>l
0 + 1 < 2
Kitchen
The kitchen is silent and untouched.

There is a refrigerator in the corner.

>l
0 + 2 >= 2
Index: 2
Kitchen
The kitchen is silent and untouched.

There is an oven in the corner.

* * *

>l
0 + 2 >= 2(random name called)(clear called)
Current table:
Name: stove, Used: true, Used by: refrigerator
Name: microwave, Used: false, Used by: Nothing
Name: refrigerator, Used: false, Used by: Nothing
Name: oven, Used: false, Used by: Nothing

Kitchen
The kitchen is silent and untouched.

There is a stove in the corner.

>x stove
You must supply a noun.

* * *

>l
0 + 0 < 2
Current table:
Name: refrigerator, Used: true, Used by: refrigerator
Name: oven, Used: false, Used by: Nothing
Name: microwave, Used: false, Used by: Nothing
Name: stove, Used: false, Used by: Nothing

Kitchen
The kitchen is silent and untouched.

There is a refrigerator in the corner.

>x refrigerator
In the corner sits a refrigerator, recently made.

>l
0 + 0 < 2
Current table:
Name: refrigerator, Used: true, Used by: refrigerator
Name: stove, Used: false, Used by: Nothing
Name: oven, Used: false, Used by: Nothing
Name: microwave, Used: false, Used by: Nothing

Kitchen
The kitchen is silent and untouched.

There is a refrigerator in the corner.

>l
0 + 0 < 2
Current table:
Name: refrigerator, Used: true, Used by: refrigerator
Name: stove, Used: false, Used by: Nothing
Name: oven, Used: false, Used by: Nothing
Name: microwave, Used: false, Used by: Nothing

Kitchen
The kitchen is silent and untouched.

There is a refrigerator in the corner.

>l
0 + 2 >= 2(random name called)(clear called)
Current table:
Name: oven, Used: true, Used by: refrigerator
Name: microwave, Used: false, Used by: Nothing
Name: stove, Used: false, Used by: Nothing
Name: refrigerator, Used: false, Used by: Nothing

Kitchen
The kitchen is silent and untouched.

There is an oven in the corner.

>x oven
Name: oven, Used: true, Used by: refrigerator
Name: microwave, Used: false, Used by: Nothing
Name: stove, Used: false, Used by: Nothing
Name: refrigerator, Used: false, Used by: Nothing
oven
*** Run-time problem P21: Attempt to look up a non-existent correspondence in the table 'Table - Info'.

In the corner sits an oven, ready for baking.

>x oven
Name: oven, Used: true, Used by: refrigerator
Name: microwave, Used: false, Used by: Nothing
Name: stove, Used: false, Used by: Nothing
Name: refrigerator, Used: false, Used by: Nothing
oven
*** Run-time problem P21: Attempt to look up a non-existent correspondence in the table 'Table - Info'.

In the corner sits an oven, ready for baking.

* * *

>l
0 + 0 < 2
Current table:
Name: refrigerator, Used: true, Used by: refrigerator
Name: oven, Used: false, Used by: Nothing
Name: microwave, Used: false, Used by: Nothing
Name: stove, Used: false, Used by: Nothing

Kitchen
The kitchen is silent and untouched.

There is a refrigerator in the corner.

>x microwave
You can't see any such thing.

* * *

>l
Current table:
Name: refrigerator, Used: true, Used by: refrigerator
Name: oven, Used: false, Used by: Nothing
Name: microwave, Used: false, Used by: Nothing
Name: stove, Used: false, Used by: Nothing
0 + 2 >= 2(random name called)(clear called)
Kitchen
The kitchen is silent and untouched.

There is a stove in the corner.

>x stove
In the corner sits a stove, off at the moment.

* * *

>l
Current table:
Name: refrigerator, Used: true, Used by: refrigerator
Name: oven, Used: false, Used by: Nothing
Name: microwave, Used: false, Used by: Nothing
Name: stove, Used: false, Used by: Nothing
0 + 1 < 2
Kitchen
The kitchen is silent and untouched.

There is a refrigerator in the corner.

>x stove
*** Run-time problem P23: Attempt to look up a non-existent entry at column 8, row 2 of the table 'Table - Info'.

You must name an object.

* * *

>l
Current table:
Name: refrigerator, Used: true, Used by: refrigerator
Name: oven, Used: false, Used by: Nothing
Name: microwave, Used: false, Used by: Nothing
Name: stove, Used: false, Used by: Nothing
0 + 0 < 2
Kitchen
The kitchen is silent and untouched.

There is a refrigerator in the corner.

>x refrigerator
The oven looks like it was made recently, with a polished white surface, and an ice/water dispenser. Index: 2

>x oven
You can't see any such thing.

* * *

>l
Current table:
Name: refrigerator, Used: true, Used by: refrigerator
Name: oven, Used: false, Used by: Nothing
Name: microwave, Used: false, Used by: Nothing
Name: stove, Used: false, Used by: Nothing
0 + 0 < 2
Kitchen
The kitchen is silent and untouched.

There is a refrigerator in the corner.

>x microwave
Name: microwave, Used: true, Used by: refrigerator
Name: refrigerator, Used: false, Used by: Nothing
Name: oven, Used: false, Used by: Nothing
Name: stove, Used: false, Used by: Nothing

*** Run-time problem P21: Attempt to look up a non-existent correspondence in the table 'Table - Info'.

In the corner sits a microwave, with a blinking clock.

* * *

>l
Current table:
Name: refrigerator, Used: true, Used by: refrigerator
Name: oven, Used: false, Used by: Nothing
Name: microwave, Used: false, Used by: Nothing
Name: stove, Used: false, Used by: Nothing
0 + 0 < 2
Kitchen
The kitchen is silent and untouched.

There is a refrigerator in the corner.

>x stove
That isn't available.

* * *

>l
Current table:
Name: refrigerator, Used: true, Used by: refrigerator
Name: oven, Used: false, Used by: Nothing
Name: microwave, Used: false, Used by: Nothing
Name: stove, Used: false, Used by: Nothing
0 + 1 < 2
Kitchen
The kitchen is silent and untouched.

There is a refrigerator in the corner.

>x oven
oven
*** Run-time problem P21: Attempt to look up a non-existent correspondence in the table 'Table - Info'.

In the corner sits a stove, off at the moment.

* * *

>l
Current table:
Name: refrigerator, Used: true, Used by: refrigerator
Name: oven, Used: false, Used by: Nothing
Name: microwave, Used: false, Used by: Nothing
Name: stove, Used: false, Used by: Nothing
0 + 0 < 2
Kitchen
The kitchen is silent and untouched.

There is a refrigerator in the corner.

>x stove
You can't see any such thing.

* * *

>l
Current table:
Name: refrigerator, Used: true, Used by: refrigerator
Name: oven, Used: false, Used by: Nothing
Name: microwave, Used: false, Used by: Nothing
Name: stove, Used: false, Used by: Nothing
0 + 0 < 2
Kitchen
The kitchen is silent and untouched.

There is a refrigerator in the corner.

>x oven
You must supply a noun.

>actions on
Actions listing on.

>x oven
[examining the oven]
[(1) special examining the oven]
[(2) examining the oven]
[(3) special examining the oven]
You must supply a noun.

[(3) special examining the oven - succeeded]

[(2) examining the oven - failed]

[(1) special examining the oven - succeeded]

[examining the oven - failed]

* * *

>l
Current table:
Name: refrigerator, Used: true, Used by: refrigerator
Name: oven, Used: false, Used by: Nothing
Name: microwave, Used: false, Used by: Nothing
Name: stove, Used: false, Used by: Nothing
0 + 0 < 2
Kitchen
The kitchen is silent and untouched.

There is a refrigerator in the corner.

>reset refrigerator
(reset called)(clear called)

>l
0 + 2 >= 2(random name called)(clear called)
Current table:
Name: oven, Used: true, Used by: refrigerator
Name: refrigerator, Used: false, Used by: Nothing
Name: microwave, Used: false, Used by: Nothing

Kitchen
The kitchen is silent and untouched.

There is an oven in the corner.

>reset fridge
(reset called)(clear called)

>l
0 + 2 >= 2(random name called)(clear called)
Current table:
Name: microwave, Used: true, Used by: refrigerator
Name: refrigerator, Used: false, Used by: Nothing
Name: oven, Used: false, Used by: Nothing

Kitchen
The kitchen is silent and untouched.

There is a microwave in the corner.

>l
0 + 0 < 2(reset called)(clear called)
Current table:
Name: microwave, Used: false, Used by: Nothing
Name: refrigerator, Used: false, Used by: refrigerator
Name: oven, Used: false, Used by: Nothing

Kitchen
The kitchen is silent and untouched.

There is a refrigerator in the corner.

* * *

>l
Current table:
Name: refrigerator, Used: true, Used by: refrigerator
Name: oven, Used: false, Used by: Nothing
Name: microwave, Used: false, Used by: Nothing
Name: stove, Used: false, Used by: Nothing
0 + 0 < 2
Kitchen
The kitchen is silent and untouched.

There is a refrigerator in the corner.

>x stove
You must supply a noun.

* * *

>l
Current table:
Name: refrigerator, Used: true, Used by: refrigerator
Name: oven, Used: false, Used by: Nothing
Name: microwave, Used: false, Used by: Nothing
Name: stove, Used: false, Used by: Nothing
0 + 0 < 2
Kitchen
The kitchen is silent and untouched.

There is a refrigerator in the corner.

>x oven
You can't see a oven.

>l
Current table:
Name: refrigerator, Used: true, Used by: refrigerator
Name: oven, Used: false, Used by: Nothing
Name: microwave, Used: false, Used by: Nothing
Name: stove, Used: false, Used by: Nothing
0 + 0 < 2
Kitchen
The kitchen is silent and untouched.

There is a refrigerator in the corner.

>l
Current table:
Name: refrigerator, Used: true, Used by: refrigerator
Name: oven, Used: false, Used by: Nothing
Name: microwave, Used: false, Used by: Nothing
Name: stove, Used: false, Used by: Nothing
0 + 2 >= 2(random name called)(clear called)
Kitchen
The kitchen is silent and untouched.

There is a microwave in the corner.

>x refrigerator
You can't see a refrigerator.

>l
Current table:
Name: microwave, Used: true, Used by: refrigerator
Name: stove, Used: false, Used by: Nothing
Name: oven, Used: false, Used by: Nothing
Name: refrigerator, Used: false, Used by: Nothing
0 + 0 < 2(Also resetting)(reset called)(clear called)
Kitchen
The kitchen is silent and untouched.

There is a refrigerator in the corner.

>l
Current table:
Name: microwave, Used: false, Used by: Nothing
Name: stove, Used: false, Used by: Nothing
Name: oven, Used: false, Used by: Nothing
Name: refrigerator, Used: true, Used by: refrigerator
0 + 0 < 2
Kitchen
The kitchen is silent and untouched.

There is a refrigerator in the corner.