Refuge
An Interactive Fiction by Dan Malear and Edward Ramirez
Release 1 / Serial number 130214 / Inform 7 build 6G60 (I6/v6.32 lib 6/12N) SD

Kitchen
The kitchen is dirty as hell.

You can see a refrigerator here.

>ffjh j
That's not a verb I recognize.